11111111111111111111
20000010000001000001
11111010111111110111
30001000000000000001
11101011111111111111
10101000000000000001
10101111111111111101
10000000000000000001
11111111111111111111